  ____        _        _      ____                           
 / ___|  ___ | |_     / \    |  _ \   ___    ___   _ __ ___  
| |  _  / _ \| __|   / _ \   | |_) | / _ \  / _ \ | '_ ` _ \ 
| |_| ||  __/| |_   / ___ \  |  _ < | (_) || (_) || | | | | |
 \____| \___| \__| /_/   \_\ |_| \_\ \___/  \___/ |_| |_| |_|
                                                             
